browserNotFoundTitle=#browser# not found!
browserNotFoundMessage=Couldn't find path for #browser#! Would you like to find it yourself?
browserNotFoundAskTitle=Select the laucher for #browser#!
new=Create New File
open=Open File
file=File
save=Save
save_as=Save As
copy=Copy Text
paste=Paste Text
settings=Settings
HTMLCode=Generate HTTP Code
fastTest=Open For Testing
FFoxTest=Open in FireFox for Testing
ChromeTest=Open in Chrome for Testing
EdgeTest=Open in Edge for Testing
OperaTest=Open in Opera for Testing
browserNotSet=#browser# is not set!
help=Help
about=About
recent=Recent Files
syntax=Syntax List
Unsaved=Unsaved Project!
DoYouSave=Would you like to save your current project?
fileBoot=Boo-T Files
fileTxT=Text Files
fileAll=All Files
fileOpenErrorTitle=File Open Error!
fileOpenError=Opening of '#path#' failed!
fileSaveErrorTitle=File Save Error!
fileSaveError=Saving to '#path#' failed!
compiler=Compiler
compilerLabel=Choose between the Python or Fortran based compilers!
browserSettings=Browser Settings
browserLabel=You can set the paths for the browsers!
browserAuto=Auto-search for browsers at startup
browserPathButtonText=Set path of #browser#
executable=Executables
SettingsOK=Save Settings
Cancel=Cancel
Defaults=Load Defaults
buttonLabel=Save or Cancel changes, also let's you load the default values.
basicSettings=Basic Settings
language=Language:
boxSize=Window Size:
boxColor=Color Theme:
dark=dark
light=light
recentList=List of recently opened files!