browserNotFoundTitle=#browser# nem található!
browserNotFoundMessage=#browser# böngészõ nem található! Szeretné mamuálisan megkeresni?
browserNotFoundAskTitle=Válassza ki a(z) #browser# alkalmazását!
new=Új Fájl Létrehozása
open=Fájl Megnyitása
file=Fájl
save=Mentés
save_as=Mentés Másként
copy=Szöveg Másolása
paste=Szöveg Beillesztése
settings=Beállítások
HTMLCode=HTTP Kód Generálása
fastTest=Megnyitás Tesztelésre
FFoxTest=Megnyitás Tesztelésre FireFox-ban
ChromeTest=Megnyitás Tesztelésre Chrome-ban
EdgeTest=Megnyitás Tesztelésre Edge-ben
OperaTest=Megnyitás Tesztelésre Operá-ban
browserNotSet=#browser# nincs beállítva!
about=Névjegy
help=Súgó
recent=Legutóbbi Fájlok
syntax=Szószedet
Unsaved=Nem Mentett Projekt!
DoYouSave=Szeretnéd menteni a jelenlegi projektet?
fileBoot=Boo-T Fájlok
fileTxT=Szöveges Fájlok
fileAll=Minden Fájl
fileOpenErrorTitle=Fájl Megnyitás Hiba!
fileOpenError='#path#' megnyitása sikertelen!
fileSaveErrorTitle=Fájl Mentés Hiba!
fileSaveError=Mentés a '#path#' címre sikertelen!
compiler=Fordító
compilerLabel=Válassz a Python vagy Fortran alapú fordítók közül!